{
  "tile_size": 32,
  "tiles": [
    "................................................................................................................",
    "................................................................................................................",
    "................................................................................................................",
    "................................................................................................................",
    "................................................................................................................",
    ".........................=.............................................=........................................",
    "...........................................o....................................................................",
    "..............=....................e..............................=....................o.......................",
    "................................................................................................................",
    ".................................................#####..........................................................",
    ".......................#####....................................................#####...........................",
    "..............................................................=.................................................",
    ".........o............................^..............o..............................^...........................",
    "...P.............................................................C.........................e....................",
    "##########################......########################....###########################......###################",
    "#######################....^^^^....##################....^^^^....##################....^^^^....###############",
    "###################.................................................................E..........................G",
    "################################################################################################################"
  ]
}
